18 12
W W W W W W W W W W W W 
W T . . . . . . . W . W
W . . . W W . . W . . W
W . . . W . . . . . . W
W W . . . W . . . W W W
W . . W W W W . . W . W
W . . . . . . . . W . W
W . . . . . W . . . . W
W W W W W . . . . W . W
W W W T M T . . . . . W 
W . . . T . . W . . W W
W . W . . W . W . . . W
W . W . . . . W W W . W
W . W . . W . W T W . W
W . W . . W . W . W . W
W . W T W . . . . . . W
W . . . W . . W . . W W
W W W W W W W W W W W W